#####
# P #
# X #
#O  #
#####
